1111111
100p0c1
1s11101
1111111

