1111111
100P0C1
1E11101
1111111
